NO maps/textures/wolfenstein/purple_stone.xpm
SO maps/textures/wolfenstein/purple_stone.xpm
WE maps/textures/wolfenstein/purple_stone.xpm
EA maps/textures/wolfenstein/purple_stone.xpm
F 20,20,20
C 200,200,200

   1111111111111111111111
  100000000000000000000001
 10000000000000000000000001
1000000000111111110000000001
1000000001        1000000001
1000000001        1000000001
1000000001        1000000001
100000000011111111000000W001
 10000000000000000000000001
  100000000000000000000001
   1111111111111111111111

