NO maps/textures/general/wet_sponge.xpm
SO maps/textures/general/wet_sponge.xpm
WE maps/textures/general/wet_sponge.xpm
EA maps/textures/general/wet_sponge.xpm
F 20,20,20
C 200,200,200


11111111111111111111111111
1E000000000000000000000001
11111111111111111111111111

