NO textures/general/wet_sponge.xpm
SO textures/general/wet_sponge.xpm
WE textures/general/wet_sponge.xpm
EA textures/general/wet_sponge.xpm
F 20,20,20
C 200,200,200


11111111111111111111111111
1W000000000000000000000001
11111111111111111111111111

