NO textures/general/wet_sponge.xpm

SO textures/general/wet_sponge.xpm

WE textures/general/wet_sponge.xpm

EA textures/general/wet_sponge.xpm

F 20,20,20

C 200,200,200


  1111111  1111111111111111111111111
  1000001  1000000000000000000000001
  1110111  1W00000000000000000000001
    101    1000000000000011111111111
11111011111100000100000001
10000000000000001 10000001
10000000000000000100000001
10000000000000000000000001
11111111111111111111111111