NO textures/wolfenstein/purple_stone.xpm
SO textures/wolfenstein/eagle.xpm
WE textures/wolfenstein/red_brick.xpm
EA textures/wolfenstein/wood.xpm

F 20,20,20
C 200,200,200

11111111111111111
10000001000000001
10000001000000001
10000000000000001
10000000000000001
10000000000S00001
11000000000000001
10000000000000001
10000000000000001
10000000000000001
10000000000000001
10000000000000001
11111111111111111