NO textures/wolfenstein/purple_stone.xpm
SO textures/wolfenstein/eagle.xpm
WE textures/wolfenstein/red_brick.xpm
EA textures/wolfenstein/wood.xpm

F 20,20,20
C 200,200,200

1111111111
1000000001
1000000001
1000000001
1010000001
100000W011
1000000001
1000000001
1100000001
1111111111
