NO textures/wolfenstein/purple_stone.xpm
SO textures/wolfenstein/eagle.xpm
WE textures/wolfenstein/red_brick.xpm
EA textures/wolfenstein/wood.xpm

F 20,20,20
C 200,200,200

1111111111
1100100001
1000010001
1000000001
1001000001
110000S001
1000000001
1000001001
1100100011
1111111111