NO maps/textures/tests/NO.xpm
SO maps/textures/tests/SO.xpm
WE maps/textures/tests/WE.xpm
EA maps/textures/tests/EA.xpm

F 20,20,20
C 200,200,200

1111111111111
100000S000011
1000000000001
1001000000001
1000000100001
1000000000001
1111111111111